1111111111
1E01C00P01
1100000C01
111C100001
1111111111