111111
1E00P1
1100C1
111C11
111111