1111111111
1E00P00001
1100C00001
111C100001
1111111111