11111111111111
1P001C11C100C1
11000000000011
10010000001001
1C011C00C110E1
11111111111111