11111111111111
1P0N101101N001
11000000000011
10010N00N01001
1001N0000N10E1
11111111111111