11111111111111
1E0N1C11C1N0C1
11000000000011
10010N00N01001
1C01N0CC0N10E1
11111111111111